############################
#............##............#
#.####.#####.##.#####.####.#
#.####.#####.##.#####.####.#
#.####.#####.##.#####.####.#
#..........................#
#.####.##.########.##.####.#
#.####.##.########.##.####.#
#......##....##....##......#
#.####.#####.##.#####.####.#
#.####.#####.##.#####.####.#
#......##..........##......#
######.##.########.##.######
######.##.########.##.######
#.........DGG##GGD.........#
######.##.########.##.######
######.##.########.##.######
######.##....P.....##.######
######.##.########.##.######
######.##.########.##.######
#............##............#
#.####.#####.##.#####.####.#
#.####.#####.##.#####.####.#
#..........................#
#.####.##.########.##.####.#
#.####.##.########.##.####.#
#......##....##....##......#
######.#####.##.#####.######
######.#####.##.#####.######
#............##............#
#.####.#####.##.#####.####.#
#.####.#####.##.#####.####.#
#............##............#
############################
