############################
#............##............#
#.####.#####.##.#####.####.#
#.####.#####.##.#####.####.#
#..........................#
#.####.#####.##.#####.####.#
#.####.#####.##.#####.####.#
#......##..........##......#
######.##.########.##.######
######.##.########.##.######
#.........DGG##GGD.........#
#.####.##.########.##.####.#
#.####.##.########.##.####.#
#.####.##....P.....##.####.#
#.####.##.########.##.####.#
#.####.##.########.##.####.#
#............##............#
#.####.#####.##.#####.####.#
#.####.#####.##.#####.####.#
#..........................#
######.#####.##.#####.######
######.#####.##.#####.######
#............##............#
#.####.#####.##.#####.####.#
#.####.#####.##.#####.####.#
#............##............#
############################
